0,0,0,0,0,1,0,1,0,1,0,3,0,0,0,0,0,0,0,0;
0,0,0,0,0,1,0,0,1,1,0,0,6,0,0,0,0,0,0,0;
0,0,0,0,0,0,1,1,1,1,2,0,1,0,0,0,0,0,0,0;
0,0,0,0,0,1,1,1,2,1,1,2,1,0,0,0,0,0,0,0;
0,0,1,1,1,1,1,1,1,2,2,2,3,2,0,0,0,0,0,0;
0,1,1,1,2,2,2,2,2,2,3,2,1,0,0,0,0,0,0,0;
11,1,1,2,2,0,1,1,1,3,0,1,1,0,0,0,0,0,0,0;
1,3,1,0,0,0,0,3,0,0,0,1,1,2,0,0,0,0,0,0;
0,0,0,1,0,0,0,1,0,0,0,1,0,0,2,0,0,0,0,0;
0,0,0,0,1,1,0,1,0,0,0,1,2,1,1,0,0,0,0,0;
0,0,0,0,0,0,1,1,0,0,0,0,1,2,3,0,0,0,0,0;
0,0,0,0,0,0,0,0,1,1,1,1,1,2,1,2,1,0,0,0;
0,0,0,0,0,0,0,0,2,0,0,1,1,2,2,4,1,2,0,0;
0,0,0,0,0,0,0,0,1,0,0,0,0,1,1,1,5,5,0,0;
10,1,0,0,0,0,0,0,1,0,1,0,1,1,1,2,0,0,0,0;
0,2,1,0,0,0,0,0,1,1,1,1,1,0,2,0,0,0,0,0;
0,0,0,0,1,0,0,0,1,0,0,0,0,0,2,1,0,0,0,0;
0,0,0,0,0,1,1,1,1,2,2,0,0,0,1,1,0,0,0,0;
0,0,0,0,0,0,0,0,0,0,2,1,1,1,1,0,0,0,0,0;
0,0,0,0,0,0,0,0,0,0,0,0,0,0,0,0,0,0,0,0;
