0,0,0,0,0,0,0,0,0,0,0,0,0,0,0,0,0,0,0,0,0,0,0,0,0,0,0,0,0,0,0,0,0,0,0,0,0,0,0,0,0,0,0,0,0,0,0,0,0,0,0,0,0,0,0,0,0,0,0,0,0,0,0,0,0,0,0,0,0,0,0,0,0,0,0,0,0,0,0,0,0,0,0,0,0,0,0,0,0,0,0,0,0,0,0,0,0,0,0,0;
0,9,9,9,9,9,9,9,9,9,10,10,10,10,10,11,11,11,11,12,12,12,12,12,13,13,13,13,13,13,14,14,14,14,15,15,15,15,16,16,16,16,16,17,17,17,17,17,18,18,18,18,18,18,18,18,18,19,19,19,19,19,19,19,19,19,20,20,20,20,20,20,20,21,21,21,21,21,21,21,21,22,22,22,22,22,22,22,22,22,22,22,22,22,22,22,22,21,21,0;
0,9,9,9,9,9,9,9,9,9,10,10,10,10,10,11,11,11,11,11,12,12,12,12,13,13,13,13,13,13,14,14,14,14,15,15,15,15,15,16,16,16,16,17,17,17,17,17,17,18,18,18,18,18,18,18,18,18,19,19,19,19,19,19,19,19,20,20,20,20,20,20,20,20,21,21,21,21,21,21,21,21,22,22,22,22,22,22,22,22,22,22,22,22,22,22,21,21,21,0;
0,9,9,9,9,9,9,9,9,9,10,10,10,10,10,11,11,11,11,11,12,12,12,12,12,13,13,13,13,13,14,14,14,14,14,15,15,15,15,16,16,16,16,16,17,17,17,17,17,17,18,18,18,18,18,18,18,18,18,19,19,19,19,19,19,19,19,20,20,20,20,20,20,20,21,21,21,21,21,21,21,21,21,21,22,22,22,22,22,22,22,22,22,22,22,21,21,21,21,0;
0,9,9,9,9,9,9,9,9,9,10,10,10,10,10,11,11,11,11,11,12,12,12,12,12,13,13,13,13,13,13,14,14,14,14,15,15,15,15,15,16,16,16,16,16,17,17,17,17,17,17,18,18,18,18,18,18,18,18,18,19,19,19,19,19,19,19,19,20,20,20,20,20,20,20,20,21,21,21,21,21,21,21,21,21,21,21,21,21,21,21,21,21,21,21,21,21,21,21,0;
0,9,9,9,9,9,9,9,9,9,10,10,10,10,10,11,11,11,11,11,12,12,12,12,12,12,13,13,13,13,13,14,14,14,14,14,15,15,15,15,16,16,16,16,16,16,17,17,17,17,17,17,17,18,18,18,18,18,18,18,18,18,19,19,19,19,19,19,19,19,20,20,20,20,20,20,20,21,21,21,21,21,21,21,21,21,21,21,21,21,21,21,21,21,21,21,21,21,21,0;
0,9,9,9,9,9,9,9,9,10,10,10,10,10,10,11,11,11,11,11,11,12,12,12,12,12,12,13,13,13,13,13,14,14,14,14,14,15,15,15,15,16,16,16,16,16,16,17,17,17,17,17,17,17,17,18,18,18,18,18,18,18,18,18,19,19,19,19,19,19,19,20,20,20,20,20,20,20,20,21,21,21,21,21,21,21,21,21,21,21,21,21,21,21,21,21,21,21,21,0;
0,9,9,9,9,9,9,9,9,10,10,10,10,10,10,10,11,11,11,11,11,12,12,12,12,12,12,13,13,13,13,13,13,14,14,14,14,14,15,15,15,15,15,16,16,16,16,16,17,17,17,17,17,17,17,17,17,17,18,18,18,18,18,18,18,18,19,19,19,19,19,19,19,20,20,20,20,20,20,20,20,21,21,21,21,21,21,21,21,21,21,21,21,21,21,21,21,21,21,0;
0,9,9,9,9,9,9,9,9,10,10,10,10,10,10,10,11,11,11,11,11,11,12,12,12,12,12,12,13,13,13,13,13,13,14,14,14,14,14,15,15,15,15,15,16,16,16,16,16,16,16,17,17,17,17,17,17,17,17,17,18,18,18,18,18,18,18,18,19,19,19,19,19,19,19,19,20,20,20,20,20,20,20,20,20,21,21,21,21,21,21,21,21,21,21,21,21,21,21,0;
0,9,9,9,9,9,9,9,10,10,10,10,10,10,10,10,11,11,11,11,11,11,11,12,12,12,12,12,12,13,13,13,13,13,13,14,14,14,14,14,15,15,15,15,15,15,16,16,16,16,16,16,16,16,17,17,17,17,17,17,17,17,17,18,18,18,18,18,18,18,18,19,19,19,19,19,19,19,20,20,20,20,20,20,20,20,20,20,21,21,21,21,21,21,21,21,21,21,21,0;
0,9,9,9,9,9,9,10,10,10,10,10,10,10,10,10,10,11,11,11,11,11,11,11,12,12,12,12,12,12,13,13,13,13,13,13,14,14,14,14,14,15,15,15,15,15,15,15,16,16,16,16,16,16,16,16,16,17,17,17,17,17,17,17,17,18,18,18,18,18,18,18,18,19,19,19,19,19,19,19,19,20,20,20,20,20,20,20,20,20,20,20,21,21,21,21,21,21,21,0;
0,9,9,9,9,10,10,10,10,10,10,10,10,10,10,10,10,11,11,11,11,11,11,11,11,12,12,12,12,12,12,12,13,13,13,13,13,14,14,14,14,14,14,15,15,15,15,15,15,15,15,16,16,16,16,16,16,16,16,16,17,17,17,17,17,17,17,17,18,18,18,18,18,18,18,18,19,19,19,19,19,19,19,19,20,20,20,20,20,20,20,20,20,20,20,21,21,21,21,0;
0,10,10,10,10,10,10,10,10,10,10,10,10,10,10,10,10,10,11,11,11,11,11,11,11,11,12,12,12,12,12,12,12,13,13,13,13,13,13,14,14,14,14,14,14,15,15,15,15,15,15,15,15,15,16,16,16,16,16,16,16,16,16,17,17,17,17,17,17,17,17,18,18,18,18,18,18,18,18,19,19,19,19,19,19,19,19,20,20,20,20,20,20,20,20,20,20,20,21,0;
0,10,10,10,10,10,10,10,10,10,10,10,10,10,10,10,10,10,10,11,11,11,11,11,11,11,11,11,12,12,12,12,12,12,12,13,13,13,13,13,13,14,14,14,14,14,14,14,15,15,15,15,15,15,15,15,15,15,16,16,16,16,16,16,16,16,17,17,17,17,17,17,17,17,18,18,18,18,18,18,18,18,19,19,19,19,19,19,19,19,20,20,20,20,20,20,20,20,20,0;
0,10,10,10,10,10,10,10,10,10,10,10,10,10,10,10,10,10,10,10,11,11,11,11,11,11,11,11,11,12,12,12,12,12,12,12,13,13,13,13,13,13,13,14,14,14,14,14,14,14,14,14,15,15,15,15,15,15,15,15,15,16,16,16,16,16,16,16,16,17,17,17,17,17,17,17,17,17,18,18,18,18,18,18,18,19,19,19,19,19,19,19,20,20,20,20,20,20,20,0;
0,10,10,10,10,10,10,10,10,10,10,10,10,10,10,10,10,10,10,10,10,10,11,11,11,11,11,11,11,11,11,12,12,12,12,12,12,12,13,13,13,13,13,13,13,13,14,14,14,14,14,14,14,14,14,14,15,15,15,15,15,15,15,15,15,16,16,16,16,16,16,16,16,17,17,17,17,17,17,17,17,18,18,18,18,18,18,19,19,19,19,19,19,19,20,20,20,20,20,0;
0,10,10,10,10,10,10,10,10,10,10,10,10,10,10,10,10,10,10,10,10,10,10,10,11,11,11,11,11,11,11,11,11,12,12,12,12,12,12,12,12,13,13,13,13,13,13,13,13,14,14,14,14,14,14,14,14,14,14,14,15,15,15,15,15,15,15,15,16,16,16,16,16,16,16,16,17,17,17,17,17,17,17,17,18,18,18,18,18,19,19,19,19,19,19,19,20,20,20,0;
0,10,10,10,10,10,10,10,10,10,10,10,10,10,10,10,10,10,10,10,10,10,10,10,10,10,11,11,11,11,11,11,11,11,11,12,12,12,12,12,12,12,12,13,13,13,13,13,13,13,13,13,13,13,14,14,14,14,14,14,14,14,14,15,15,15,15,15,15,15,15,16,16,16,16,16,16,16,16,16,17,17,17,17,17,17,18,18,18,18,18,19,19,19,19,19,19,19,20,0;
0,10,10,10,10,10,10,10,10,10,10,10,10,10,10,10,10,10,10,10,10,10,10,10,10,10,10,11,11,11,11,11,11,11,11,11,11,12,12,12,12,12,12,12,12,12,13,13,13,13,13,13,13,13,13,13,13,13,14,14,14,14,14,14,14,14,15,15,15,15,15,15,15,15,15,16,16,16,16,16,16,16,17,17,17,17,17,17,18,18,18,18,18,19,19,19,19,19,19,0;
0,11,11,11,11,11,10,10,10,10,10,10,10,10,10,10,10,10,10,10,10,10,10,10,10,10,10,10,10,11,11,11,11,11,11,11,11,11,11,11,12,12,12,12,12,12,12,12,12,12,13,13,13,13,13,13,13,13,13,13,13,14,14,14,14,14,14,14,14,14,15,15,15,15,15,15,15,15,15,16,16,16,16,16,16,17,17,17,17,17,18,18,18,18,18,19,19,19,19,0;
0,11,11,11,11,11,11,11,10,10,10,10,10,10,10,10,10,10,10,10,10,10,10,10,10,10,10,10,10,10,10,11,11,11,11,11,11,11,11,11,11,11,11,12,12,12,12,12,12,12,12,12,12,12,12,13,13,13,13,13,13,13,13,13,14,14,14,14,14,14,14,14,14,15,15,15,15,15,15,15,15,16,16,16,16,16,16,17,17,17,17,18,18,18,18,18,19,19,19,0;
0,11,11,11,11,11,11,11,11,11,10,10,10,10,10,10,10,10,10,10,10,10,10,10,10,10,10,10,10,10,10,10,10,10,11,11,11,11,11,11,11,11,11,11,11,11,12,12,12,12,12,12,12,12,12,12,12,12,12,13,13,13,13,13,13,13,13,13,14,14,14,14,14,14,14,14,14,15,15,15,15,15,15,15,16,16,16,16,17,17,17,17,17,18,18,18,18,18,19,0;
0,11,11,11,11,11,11,11,11,11,11,10,10,10,10,10,10,10,10,10,10,10,10,10,10,10,10,10,10,10,10,10,10,10,10,10,11,11,11,11,11,11,11,11,11,11,11,11,11,11,12,12,12,12,12,12,12,12,12,12,12,12,13,13,13,13,13,13,13,13,13,14,14,14,14,14,14,14,14,14,15,15,15,15,15,16,16,16,16,16,17,17,17,17,18,18,18,18,18,0;
0,11,11,11,11,11,11,11,11,11,11,10,10,10,10,10,10,10,10,10,10,10,10,10,10,10,10,10,10,10,10,10,10,10,10,10,10,10,10,10,11,11,11,11,11,11,11,11,11,11,11,11,11,11,12,12,12,12,12,12,12,12,12,12,12,13,13,13,13,13,13,13,13,13,14,14,14,14,14,14,14,14,15,15,15,15,15,16,16,16,16,17,17,17,17,17,18,18,18,0;
0,11,11,11,11,11,11,11,11,11,11,11,10,10,10,10,10,10,10,10,10,10,10,10,10,10,10,10,10,10,10,10,10,10,10,10,10,10,10,10,10,10,10,11,11,11,11,11,11,11,11,11,11,11,11,11,11,11,12,12,12,12,12,12,12,12,12,12,13,13,13,13,13,13,13,13,13,13,14,14,14,14,14,14,15,15,15,15,16,16,16,16,16,17,17,17,17,17,18,0;
0,11,11,11,11,11,11,11,11,11,11,11,11,10,10,10,10,10,10,10,10,10,10,10,10,10,10,10,10,10,10,10,10,10,10,10,10,10,10,10,10,10,10,10,10,10,10,11,11,11,11,11,11,11,11,11,11,11,11,11,11,12,12,12,12,12,12,12,12,12,12,13,13,13,13,13,13,13,13,13,13,14,14,14,14,14,15,15,15,15,16,16,16,16,17,17,17,17,17,0;
0,12,12,12,11,11,11,11,11,11,11,11,11,10,10,10,10,10,10,10,10,10,10,10,10,10,10,10,10,10,10,10,10,10,10,10,10,10,10,10,10,10,10,10,10,10,10,10,10,10,11,11,11,11,11,11,11,11,11,11,11,11,11,12,12,12,12,12,12,12,12,12,12,12,13,13,13,13,13,13,13,13,14,14,14,14,14,15,15,15,15,16,16,16,16,16,17,17,17,0;
0,12,12,12,12,11,11,11,11,11,11,11,11,11,10,10,10,10,10,10,10,10,10,10,10,10,10,10,10,10,10,10,10,10,10,10,10,10,10,10,10,10,10,10,10,10,10,10,10,10,10,10,10,10,11,11,11,11,11,11,11,11,11,11,11,12,12,12,12,12,12,12,12,12,12,12,12,13,13,13,13,13,13,13,14,14,14,14,15,15,15,15,15,16,16,16,16,16,17,0;
0,12,12,12,12,12,12,11,11,11,11,11,11,11,11,10,10,10,10,10,10,10,10,10,10,10,10,10,10,10,10,10,10,10,10,10,10,10,10,10,10,10,10,10,10,10,10,10,10,10,10,10,10,10,10,10,10,11,11,11,11,11,11,11,11,11,11,11,12,12,12,12,12,12,12,12,12,12,12,13,13,13,13,13,13,14,14,14,14,14,15,15,15,15,16,16,16,16,16,0;
0,12,12,12,12,12,12,12,11,11,11,11,11,11,11,11,10,10,10,10,10,10,10,10,10,10,10,10,10,10,10,10,10,10,10,10,10,10,10,10,10,10,10,10,10,10,10,10,10,10,10,10,10,10,10,10,10,10,10,11,11,11,11,11,11,11,11,11,11,11,12,12,12,12,12,12,12,12,12,12,12,13,13,13,13,13,13,14,14,14,14,15,15,15,15,15,16,16,16,0;
0,12,12,12,12,12,12,12,12,12,11,11,11,11,11,11,11,10,10,10,10,10,10,10,10,10,10,10,10,10,10,10,10,10,10,10,10,10,10,10,10,10,10,10,10,10,10,10,10,10,10,10,10,10,10,10,10,10,10,10,10,11,11,11,11,11,11,11,11,11,11,11,12,12,12,12,12,12,12,12,12,12,12,13,13,13,13,13,14,14,14,14,14,15,15,15,15,15,15,0;
0,12,12,12,12,12,12,12,12,12,12,11,11,11,11,11,11,11,10,10,10,10,10,10,10,10,10,10,10,10,10,10,10,10,10,10,10,10,9,9,9,9,9,9,9,9,9,9,9,9,10,10,10,10,10,10,10,10,10,10,10,10,10,11,11,11,11,11,11,11,11,11,11,11,12,12,12,12,12,12,12,12,12,12,13,13,13,13,13,14,14,14,14,14,14,15,15,15,15,0;
0,13,12,12,12,12,12,12,12,12,12,12,11,11,11,11,11,11,11,10,10,10,10,10,10,10,10,10,10,10,10,10,10,10,10,10,10,9,9,9,9,9,9,9,9,9,9,9,9,9,9,9,9,9,10,10,10,10,10,10,10,10,10,10,10,11,11,11,11,11,11,11,11,11,11,11,12,12,12,12,12,12,12,12,12,13,13,13,13,13,13,14,14,14,14,14,14,14,15,0;
0,13,13,13,13,12,12,12,12,12,12,12,12,11,11,11,11,11,11,11,10,10,10,10,10,10,10,10,10,10,10,10,10,10,10,10,9,9,9,9,9,9,9,9,9,9,9,9,9,9,9,9,9,9,9,9,9,10,10,10,10,10,10,10,10,10,11,11,11,11,11,11,11,11,11,11,11,11,12,12,12,12,12,12,12,12,12,13,13,13,13,13,13,14,14,14,14,14,14,0;
0,13,13,13,13,13,13,12,12,12,12,12,12,12,12,11,11,11,11,11,11,11,10,10,10,10,10,10,10,10,10,10,10,10,10,10,9,9,9,9,9,9,9,9,9,9,9,9,9,9,9,9,9,9,9,9,9,9,9,10,10,10,10,10,10,10,10,10,11,11,11,11,11,11,11,11,11,11,11,11,12,12,12,12,12,12,12,12,13,13,13,13,13,13,13,14,14,14,14,0;
0,13,13,13,13,13,13,13,13,12,12,12,12,12,12,12,11,11,11,11,11,11,11,11,10,10,10,10,10,10,10,10,10,10,10,10,9,9,9,9,9,9,9,9,9,9,9,9,9,9,9,9,9,9,9,9,9,9,9,9,10,10,10,10,10,10,10,10,10,11,11,11,11,11,11,11,11,11,11,11,11,12,12,12,12,12,12,12,12,12,13,13,13,13,13,13,13,13,13,0;
0,13,13,13,13,13,13,13,13,13,12,12,12,12,12,12,12,11,11,11,11,11,11,11,11,10,10,10,10,10,10,10,10,10,10,10,10,9,9,9,9,9,9,9,9,9,9,9,9,9,9,9,9,9,9,9,9,9,9,9,9,9,10,10,10,10,10,10,10,11,11,11,11,11,11,11,11,11,11,11,11,11,12,12,12,12,12,12,12,12,12,12,13,13,13,13,13,13,13,0;
0,14,13,13,13,13,13,13,13,13,13,13,12,12,12,12,12,12,11,11,11,11,11,11,11,11,11,11,10,10,10,10,10,10,10,10,10,9,9,9,9,9,9,9,9,9,9,8,8,8,8,8,8,9,9,9,9,9,9,9,9,9,9,10,10,10,10,10,10,10,11,11,11,11,11,11,11,11,11,11,11,11,11,11,12,12,12,12,12,12,12,12,12,12,12,12,12,13,13,0;
0,14,14,14,14,13,13,13,13,13,13,13,13,12,12,12,12,12,12,12,11,11,11,11,11,11,11,11,11,10,10,10,10,10,10,10,10,9,9,9,9,9,9,9,9,8,8,8,8,8,8,8,8,8,8,8,9,9,9,9,9,9,9,9,10,10,10,10,10,10,10,11,11,11,11,11,11,11,11,11,11,11,11,11,11,11,12,12,12,12,12,12,12,12,12,12,12,12,12,0;
0,14,14,14,14,14,14,13,13,13,13,13,13,13,13,12,12,12,12,12,12,11,11,11,11,11,11,11,11,11,10,10,10,10,10,10,10,9,9,9,9,9,9,9,8,8,8,8,8,8,8,8,8,8,8,8,8,9,9,9,9,9,9,9,10,10,10,10,10,10,10,11,11,11,11,11,11,11,11,11,11,11,11,11,11,11,11,11,11,11,12,12,12,12,12,12,12,12,12,0;
0,14,14,14,14,14,14,14,14,13,13,13,13,13,13,13,12,12,12,12,12,12,12,11,11,11,11,11,11,11,11,10,10,10,10,10,10,9,9,9,9,9,9,8,8,8,8,8,8,8,8,8,8,8,8,8,8,8,8,9,9,9,9,9,9,10,10,10,10,10,10,11,11,11,11,11,11,11,11,11,11,11,11,11,11,11,11,11,11,11,11,11,11,11,11,11,11,11,11,0;
0,14,14,14,14,14,14,14,14,14,14,13,13,13,13,13,13,12,12,12,12,12,12,12,11,11,11,11,11,11,11,11,10,10,10,10,10,9,9,9,9,9,9,8,8,8,8,8,8,8,8,8,8,8,8,8,8,8,8,8,9,9,9,9,9,9,10,10,10,10,10,10,11,11,11,11,11,11,11,11,11,11,11,11,11,11,11,11,11,11,11,11,11,11,11,11,11,11,11,0;
0,14,14,14,14,14,14,14,14,14,14,14,13,13,13,13,13,13,12,12,12,12,12,12,12,12,11,11,11,11,11,11,10,10,10,10,10,9,9,9,9,9,9,8,8,8,8,8,8,8,8,8,8,8,8,8,8,8,8,8,8,9,9,9,9,9,10,10,10,10,10,10,11,11,11,11,11,11,11,11,11,11,11,11,11,11,11,11,11,11,11,11,11,11,11,11,11,11,11,0;
0,15,15,15,15,14,14,14,14,14,14,14,14,13,13,13,13,13,13,13,12,12,12,12,12,12,12,11,11,11,11,11,11,10,10,10,10,9,9,9,9,9,8,8,8,8,8,8,8,8,7,7,7,8,8,8,8,8,8,8,8,9,9,9,9,9,10,10,10,10,10,10,11,11,11,11,11,11,11,11,11,11,11,11,11,11,11,11,11,11,11,11,11,11,10,10,10,10,10,0;
0,15,15,15,15,15,15,14,14,14,14,14,14,14,14,13,13,13,13,13,13,12,12,12,12,12,12,12,11,11,11,11,11,10,10,10,10,10,9,9,9,9,8,8,8,8,8,8,7,7,7,7,7,7,7,8,8,8,8,8,8,8,9,9,9,9,9,10,10,10,10,10,10,11,11,11,11,11,11,11,11,11,11,11,11,11,11,11,11,10,10,10,10,10,10,10,10,10,10,0;
0,15,15,15,15,15,15,15,15,14,14,14,14,14,14,14,13,13,13,13,13,13,12,12,12,12,12,12,12,11,11,11,11,11,10,10,10,10,9,9,9,9,8,8,8,8,8,7,7,7,7,7,7,7,7,7,8,8,8,8,8,8,9,9,9,9,9,10,10,10,10,10,10,11,11,11,11,11,11,11,11,11,11,11,11,11,10,10,10,10,10,10,10,10,10,10,10,10,10,0;
0,15,15,15,15,15,15,15,15,15,14,14,14,14,14,14,14,13,13,13,13,13,13,12,12,12,12,12,12,12,11,11,11,11,10,10,10,10,9,9,9,9,8,8,8,8,8,7,7,7,7,7,7,7,7,7,7,8,8,8,8,8,8,9,9,9,9,9,10,10,10,10,10,10,11,11,11,11,11,11,11,11,11,11,10,10,10,10,10,10,10,10,10,10,10,10,10,9,9,0;
0,15,15,15,15,15,15,15,15,15,15,14,14,14,14,14,14,14,13,13,13,13,13,13,12,12,12,12,12,12,11,11,11,11,10,10,10,10,9,9,9,9,8,8,8,8,7,7,7,7,7,7,7,7,7,7,7,7,8,8,8,8,8,9,9,9,9,9,10,10,10,10,10,10,11,11,11,11,11,11,11,11,11,10,10,10,10,10,10,10,10,10,10,10,9,9,9,9,9,0;
0,15,15,15,15,15,15,15,15,15,15,15,14,14,14,14,14,14,13,13,13,13,13,13,13,12,12,12,12,12,11,11,11,11,10,10,10,10,9,9,9,9,8,8,8,8,7,7,7,7,7,7,7,7,7,7,7,7,7,8,8,8,8,8,9,9,9,9,10,10,10,10,10,10,10,11,11,11,11,11,11,10,10,10,10,10,10,10,10,10,10,10,9,9,9,9,9,9,9,0;
0,16,16,15,15,15,15,15,15,15,15,15,15,14,14,14,14,14,14,13,13,13,13,13,13,12,12,12,12,12,12,11,11,11,10,10,10,10,9,9,9,8,8,8,8,8,7,7,7,7,7,7,7,7,7,7,7,7,7,8,8,8,8,8,9,9,9,9,9,10,10,10,10,10,10,10,11,11,11,10,10,10,10,10,10,10,10,10,10,10,9,9,9,9,9,9,9,9,9,0;
0,16,16,16,16,15,15,15,15,15,15,15,15,14,14,14,14,14,14,14,13,13,13,13,13,13,12,12,12,12,12,11,11,11,11,10,10,10,9,9,9,8,8,8,8,7,7,7,7,7,7,7,7,7,7,7,7,7,7,7,8,8,8,8,9,9,9,9,9,10,10,10,10,10,10,10,10,10,10,10,10,10,10,10,10,10,10,10,10,9,9,9,9,9,9,9,9,9,8,0;
0,16,16,16,16,16,15,15,15,15,15,15,15,15,14,14,14,14,14,14,13,13,13,13,13,13,12,12,12,12,12,11,11,11,11,10,10,10,9,9,9,8,8,8,8,7,7,7,7,7,7,7,7,7,7,7,7,7,7,7,8,8,8,8,8,9,9,9,9,9,10,10,10,10,10,10,10,10,10,10,10,10,10,10,10,10,10,10,9,9,9,9,9,9,9,9,8,8,8,0;
0,16,16,16,16,16,16,15,15,15,15,15,15,15,14,14,14,14,14,14,13,13,13,13,13,13,12,12,12,12,12,11,11,11,11,10,10,10,9,9,9,8,8,8,8,7,7,7,7,7,7,7,7,7,7,7,7,7,7,7,8,8,8,8,8,9,9,9,9,9,10,10,10,10,10,10,10,10,10,10,10,10,10,10,10,10,9,9,9,9,9,9,9,9,8,8,8,8,8,0;
0,16,16,16,16,16,16,15,15,15,15,15,15,15,15,14,14,14,14,14,13,13,13,13,13,13,13,12,12,12,12,11,11,11,11,10,10,10,9,9,9,8,8,8,8,7,7,7,7,7,7,7,7,7,7,7,7,7,7,7,7,8,8,8,8,8,9,9,9,9,9,10,10,10,10,10,10,10,10,10,10,10,10,10,10,9,9,9,9,9,9,9,9,8,8,8,8,8,8,0;
0,16,16,16,16,16,16,16,15,15,15,15,15,15,15,14,14,14,14,14,14,13,13,13,13,13,13,12,12,12,12,11,11,11,11,10,10,10,9,9,9,8,8,8,8,7,7,7,7,7,7,7,7,7,7,7,7,7,7,7,7,8,8,8,8,8,9,9,9,9,9,10,10,10,10,10,10,10,10,10,10,10,10,10,9,9,9,9,9,9,9,9,8,8,8,8,8,8,8,0;
0,16,16,16,16,16,16,16,16,15,15,15,15,15,15,14,14,14,14,14,14,13,13,13,13,13,13,12,12,12,12,11,11,11,11,10,10,10,9,9,9,9,8,8,8,7,7,7,7,7,7,7,7,7,7,7,7,7,7,7,7,8,8,8,8,8,9,9,9,9,9,9,10,10,10,10,10,10,10,10,10,10,10,9,9,9,9,9,9,9,8,8,8,8,8,8,8,8,8,0;
0,16,16,16,16,16,16,16,16,15,15,15,15,15,15,15,14,14,14,14,14,13,13,13,13,13,13,12,12,12,12,11,11,11,11,10,10,10,9,9,9,9,8,8,8,8,7,7,7,7,7,7,7,7,7,7,7,7,7,7,7,8,8,8,8,8,9,9,9,9,9,9,9,10,10,10,10,10,10,10,10,9,9,9,9,9,9,9,9,8,8,8,8,8,8,8,8,7,7,0;
0,16,16,16,16,16,16,16,16,16,15,15,15,15,15,15,14,14,14,14,14,13,13,13,13,13,13,12,12,12,12,12,11,11,11,10,10,10,9,9,9,9,8,8,8,8,7,7,7,7,7,7,7,7,7,7,7,7,7,7,7,8,8,8,8,8,8,9,9,9,9,9,9,9,10,10,10,10,10,9,9,9,9,9,9,9,9,9,8,8,8,8,8,8,8,7,7,7,7,0;
0,16,16,16,16,16,16,16,16,16,16,15,15,15,15,15,14,14,14,14,14,14,13,13,13,13,13,12,12,12,12,12,11,11,11,10,10,10,10,9,9,9,8,8,8,8,8,7,7,7,7,7,7,7,7,7,7,7,7,7,7,8,8,8,8,8,8,9,9,9,9,9,9,9,9,9,10,9,9,9,9,9,9,9,9,9,9,8,8,8,8,8,8,8,7,7,7,7,7,0;
0,16,16,16,16,16,16,16,16,16,16,15,15,15,15,15,15,14,14,14,14,14,13,13,13,13,13,12,12,12,12,12,11,11,11,10,10,10,10,9,9,9,9,8,8,8,8,7,7,7,7,7,7,7,7,7,7,7,7,7,8,8,8,8,8,8,8,9,9,9,9,9,9,9,9,9,9,9,9,9,9,9,9,9,9,9,8,8,8,8,8,8,7,7,7,7,7,7,7,0;
0,17,17,16,16,16,16,16,16,16,16,16,15,15,15,15,15,14,14,14,14,14,13,13,13,13,13,13,12,12,12,12,11,11,11,11,10,10,10,9,9,9,9,8,8,8,8,8,7,7,7,7,7,7,7,7,7,7,7,7,8,8,8,8,8,8,8,9,9,9,9,9,9,9,9,9,9,9,9,9,9,9,9,9,9,8,8,8,8,8,8,7,7,7,7,7,7,7,7,0;
0,17,17,17,17,16,16,16,16,16,16,16,15,15,15,15,15,14,14,14,14,14,13,13,13,13,13,13,12,12,12,12,11,11,11,11,10,10,10,10,9,9,9,9,8,8,8,8,8,7,7,7,7,7,7,7,7,7,7,8,8,8,8,8,8,8,8,9,9,9,9,9,9,9,9,9,9,9,9,9,9,9,9,9,8,8,8,8,8,8,7,7,7,7,7,7,7,6,6,0;
0,17,17,17,17,17,16,16,16,16,16,16,16,15,15,15,15,15,14,14,14,14,13,13,13,13,13,13,12,12,12,12,11,11,11,11,10,10,10,10,9,9,9,9,8,8,8,8,8,8,7,7,7,7,7,7,7,7,8,8,8,8,8,8,8,8,8,9,9,9,9,9,9,9,9,9,9,9,9,9,9,9,9,8,8,8,8,8,8,7,7,7,7,7,7,6,6,6,6,0;
0,17,17,17,17,17,17,16,16,16,16,16,16,15,15,15,15,15,14,14,14,14,14,13,13,13,13,13,12,12,12,12,12,11,11,11,11,10,10,10,9,9,9,9,9,8,8,8,8,8,8,8,8,7,7,8,8,8,8,8,8,8,8,8,8,8,8,9,9,9,9,9,9,9,9,9,9,9,9,9,9,9,8,8,8,8,8,8,7,7,7,7,7,7,6,6,6,6,6,0;
0,17,17,17,17,17,17,17,16,16,16,16,16,15,15,15,15,15,14,14,14,14,14,13,13,13,13,13,12,12,12,12,12,11,11,11,11,10,10,10,10,9,9,9,9,9,8,8,8,8,8,8,8,8,8,8,8,8,8,8,8,8,8,8,8,8,9,9,9,9,9,9,9,9,9,9,9,9,9,9,9,8,8,8,8,8,8,7,7,7,7,7,7,6,6,6,6,6,6,0;
0,17,17,17,17,17,17,17,17,16,16,16,16,16,15,15,15,15,14,14,14,14,14,13,13,13,13,13,13,12,12,12,12,11,11,11,11,10,10,10,10,10,9,9,9,9,9,8,8,8,8,8,8,8,8,8,8,8,8,8,8,8,8,8,8,8,9,9,9,9,9,9,9,9,9,9,9,9,9,9,8,8,8,8,8,8,7,7,7,7,7,7,6,6,6,6,6,6,5,0;
0,17,17,17,17,17,17,17,17,16,16,16,16,16,15,15,15,15,15,14,14,14,14,13,13,13,13,13,13,12,12,12,12,12,11,11,11,11,10,10,10,10,9,9,9,9,9,9,8,8,8,8,8,8,8,8,8,8,8,8,8,8,8,8,8,9,9,9,9,9,9,9,9,9,9,9,9,9,9,8,8,8,8,8,8,8,7,7,7,7,7,6,6,6,6,6,6,5,5,0;
0,17,17,17,17,17,17,17,17,17,16,16,16,16,16,15,15,15,15,14,14,14,14,14,13,13,13,13,13,12,12,12,12,12,11,11,11,11,10,10,10,10,10,9,9,9,9,9,9,8,8,8,8,8,8,8,8,8,8,8,8,8,8,8,9,9,9,9,9,9,9,9,9,9,9,9,9,9,9,8,8,8,8,8,8,7,7,7,7,7,6,6,6,6,6,5,5,5,5,0;
0,18,18,17,17,17,17,17,17,17,16,16,16,16,16,15,15,15,15,14,14,14,14,14,13,13,13,13,13,13,12,12,12,12,11,11,11,11,11,10,10,10,10,10,9,9,9,9,9,9,9,9,8,8,8,8,8,8,8,8,8,8,8,9,9,9,9,9,9,9,9,9,9,9,9,9,9,9,8,8,8,8,8,8,7,7,7,7,7,6,6,6,6,6,5,5,5,5,5,0;
0,18,18,18,18,17,17,17,17,17,17,16,16,16,16,16,15,15,15,15,14,14,14,14,14,13,13,13,13,13,12,12,12,12,12,11,11,11,11,11,10,10,10,10,10,9,9,9,9,9,9,9,9,9,9,9,8,8,8,9,9,9,9,9,9,9,9,9,9,9,9,9,9,9,9,9,9,8,8,8,8,8,8,8,7,7,7,7,6,6,6,6,6,5,5,5,5,5,5,0;
0,18,18,18,18,18,17,17,17,17,17,17,16,16,16,16,15,15,15,15,14,14,14,14,14,13,13,13,13,13,13,12,12,12,12,12,11,11,11,11,11,10,10,10,10,10,9,9,9,9,9,9,9,9,9,9,9,9,9,9,9,9,9,9,9,9,9,9,9,9,9,9,9,9,9,9,9,8,8,8,8,8,8,7,7,7,7,7,6,6,6,6,5,5,5,5,5,5,4,0;
0,18,18,18,18,18,18,17,17,17,17,17,16,16,16,16,15,15,15,15,15,14,14,14,14,13,13,13,13,13,13,12,12,12,12,12,11,11,11,11,11,10,10,10,10,10,10,10,9,9,9,9,9,9,9,9,9,9,9,9,9,9,9,9,9,9,9,9,9,9,9,9,9,9,9,9,8,8,8,8,8,8,8,7,7,7,7,6,6,6,6,6,5,5,5,5,5,4,4,0;
0,18,18,18,18,18,18,18,17,17,17,17,17,16,16,16,16,15,15,15,15,14,14,14,14,14,13,13,13,13,13,13,12,12,12,12,12,11,11,11,11,11,10,10,10,10,10,10,10,9,9,9,9,9,9,9,9,9,9,9,9,9,9,9,9,9,9,9,9,9,9,9,9,9,9,9,8,8,8,8,8,8,7,7,7,7,7,6,6,6,6,5,5,5,5,5,4,4,4,0;
0,18,18,18,18,18,18,18,18,17,17,17,17,16,16,16,16,15,15,15,15,15,14,14,14,14,14,13,13,13,13,13,12,12,12,12,12,12,11,11,11,11,11,10,10,10,10,10,10,10,10,9,9,9,9,9,9,9,9,9,9,9,9,9,9,9,9,9,9,9,9,9,9,9,9,9,8,8,8,8,8,8,7,7,7,7,6,6,6,6,5,5,5,5,5,4,4,4,4,0;
0,18,18,18,18,18,18,18,18,17,17,17,17,17,16,16,16,16,15,15,15,15,14,14,14,14,14,13,13,13,13,13,13,12,12,12,12,12,11,11,11,11,11,11,11,10,10,10,10,10,10,10,10,9,9,9,9,9,9,9,9,9,9,9,9,9,9,9,9,9,9,9,9,9,9,8,8,8,8,8,8,8,7,7,7,7,6,6,6,6,5,5,5,5,4,4,4,4,4,0;
0,19,19,18,18,18,18,18,18,18,17,17,17,17,16,16,16,16,15,15,15,15,15,14,14,14,14,14,13,13,13,13,13,13,12,12,12,12,12,11,11,11,11,11,11,11,10,10,10,10,10,10,10,10,10,10,9,9,9,9,9,9,9,9,9,9,9,9,9,9,9,9,9,9,9,8,8,8,8,8,8,7,7,7,7,7,6,6,6,5,5,5,5,5,4,4,4,4,4,0;
0,19,19,19,19,18,18,18,18,18,18,17,17,17,17,16,16,16,16,15,15,15,15,14,14,14,14,14,14,13,13,13,13,13,13,12,12,12,12,12,11,11,11,11,11,11,11,10,10,10,10,10,10,10,10,10,10,10,9,9,9,9,9,9,9,9,9,9,9,9,9,9,9,9,9,8,8,8,8,8,8,7,7,7,7,6,6,6,6,5,5,5,5,4,4,4,4,4,3,0;
0,19,19,19,19,19,18,18,18,18,18,17,17,17,17,16,16,16,16,15,15,15,15,15,14,14,14,14,14,14,13,13,13,13,13,12,12,12,12,12,12,11,11,11,11,11,11,11,10,10,10,10,10,10,10,10,10,10,10,10,10,9,9,9,9,9,9,9,9,9,9,9,9,9,9,8,8,8,8,8,8,7,7,7,7,6,6,6,6,5,5,5,5,4,4,4,4,4,3,0;
0,19,19,19,19,19,19,18,18,18,18,18,17,17,17,17,16,16,16,16,15,15,15,15,15,14,14,14,14,14,14,13,13,13,13,13,12,12,12,12,12,12,11,11,11,11,11,11,11,10,10,10,10,10,10,10,10,10,10,10,10,10,10,9,9,9,9,9,9,9,9,9,9,9,9,8,8,8,8,8,8,7,7,7,7,6,6,6,5,5,5,5,4,4,4,4,4,3,3,0;
0,19,19,19,19,19,19,18,18,18,18,18,17,17,17,17,17,16,16,16,16,15,15,15,15,14,14,14,14,14,14,13,13,13,13,13,13,12,12,12,12,12,12,11,11,11,11,11,11,11,11,10,10,10,10,10,10,10,10,10,10,10,10,10,10,9,9,9,9,9,9,9,9,9,9,8,8,8,8,8,8,7,7,7,7,6,6,6,5,5,5,5,4,4,4,4,3,3,3,0;
0,19,19,19,19,19,19,19,18,18,18,18,18,17,17,17,17,16,16,16,16,15,15,15,15,15,14,14,14,14,14,14,13,13,13,13,13,13,12,12,12,12,12,12,11,11,11,11,11,11,11,11,10,10,10,10,10,10,10,10,10,10,10,10,10,10,9,9,9,9,9,9,9,9,9,8,8,8,8,8,7,7,7,7,6,6,6,6,5,5,5,4,4,4,4,4,3,3,3,0;
0,19,19,19,19,19,19,19,19,18,18,18,18,17,17,17,17,16,16,16,16,16,15,15,15,15,15,14,14,14,14,14,14,13,13,13,13,13,13,12,12,12,12,12,12,11,11,11,11,11,11,11,11,10,10,10,10,10,10,10,10,10,10,10,10,10,9,9,9,9,9,9,9,9,9,8,8,8,8,8,7,7,7,7,6,6,6,5,5,5,5,4,4,4,4,3,3,3,3,0;
0,19,19,19,19,19,19,19,19,18,18,18,18,18,17,17,17,17,16,16,16,16,15,15,15,15,15,15,14,14,14,14,14,14,13,13,13,13,13,13,12,12,12,12,12,12,11,11,11,11,11,11,11,11,11,10,10,10,10,10,10,10,10,10,10,10,10,9,9,9,9,9,9,9,9,8,8,8,8,8,7,7,7,7,6,6,6,5,5,5,5,4,4,4,4,3,3,3,3,0;
0,19,19,19,19,19,19,19,19,19,18,18,18,18,17,17,17,17,16,16,16,16,16,15,15,15,15,15,14,14,14,14,14,14,13,13,13,13,13,13,13,12,12,12,12,12,12,12,11,11,11,11,11,11,11,11,11,10,10,10,10,10,10,10,10,10,10,9,9,9,9,9,9,9,9,8,8,8,8,8,7,7,7,6,6,6,6,5,5,5,4,4,4,4,3,3,3,3,3,0;
0,20,20,19,19,19,19,19,19,19,18,18,18,18,17,17,17,17,17,16,16,16,16,15,15,15,15,15,15,14,14,14,14,14,14,13,13,13,13,13,13,13,12,12,12,12,12,12,12,11,11,11,11,11,11,11,11,11,10,10,10,10,10,10,10,10,10,10,9,9,9,9,9,9,8,8,8,8,8,7,7,7,7,6,6,6,5,5,5,5,4,4,4,4,3,3,3,3,2,0;
0,20,20,20,19,19,19,19,19,19,18,18,18,18,18,17,17,17,17,16,16,16,16,16,15,15,15,15,15,15,14,14,14,14,14,14,13,13,13,13,13,13,13,12,12,12,12,12,12,12,11,11,11,11,11,11,11,11,11,10,10,10,10,10,10,10,10,10,9,9,9,9,9,9,8,8,8,8,8,7,7,7,7,6,6,6,5,5,5,4,4,4,4,3,3,3,3,3,2,0;
0,20,20,20,19,19,19,19,19,19,19,18,18,18,18,17,17,17,17,16,16,16,16,16,15,15,15,15,15,15,14,14,14,14,14,14,14,13,13,13,13,13,13,13,12,12,12,12,12,12,12,11,11,11,11,11,11,11,11,11,10,10,10,10,10,10,10,10,9,9,9,9,9,9,8,8,8,8,8,7,7,7,6,6,6,6,5,5,5,4,4,4,4,3,3,3,3,2,2,0;
0,20,20,20,20,19,19,19,19,19,19,18,18,18,18,17,17,17,17,17,16,16,16,16,15,15,15,15,15,15,15,14,14,14,14,14,14,13,13,13,13,13,13,13,13,12,12,12,12,12,12,12,12,11,11,11,11,11,11,11,11,10,10,10,10,10,10,10,9,9,9,9,9,9,8,8,8,8,7,7,7,7,6,6,6,5,5,5,5,4,4,4,3,3,3,3,2,2,2,0;
0,20,20,20,20,19,19,19,19,19,19,18,18,18,18,18,17,17,17,17,16,16,16,16,16,15,15,15,15,15,15,14,14,14,14,14,14,14,13,13,13,13,13,13,13,13,12,12,12,12,12,12,12,12,11,11,11,11,11,11,11,11,10,10,10,10,10,10,9,9,9,9,9,9,8,8,8,8,7,7,7,7,6,6,6,5,5,5,4,4,4,4,3,3,3,3,2,2,2,0;
0,20,20,20,20,20,19,19,19,19,19,18,18,18,18,18,17,17,17,17,16,16,16,16,16,15,15,15,15,15,15,15,14,14,14,14,14,14,14,13,13,13,13,13,13,13,13,12,12,12,12,12,12,12,12,11,11,11,11,11,11,11,10,10,10,10,10,10,9,9,9,9,9,8,8,8,8,8,7,7,7,7,6,6,6,5,5,5,4,4,4,3,3,3,3,2,2,2,2,0;
0,20,20,20,20,20,19,19,19,19,19,19,18,18,18,18,17,17,17,17,16,16,16,16,16,15,15,15,15,15,15,15,14,14,14,14,14,14,14,14,13,13,13,13,13,13,13,13,12,12,12,12,12,12,12,12,11,11,11,11,11,11,11,10,10,10,10,10,9,9,9,9,9,8,8,8,8,8,7,7,7,6,6,6,5,5,5,5,4,4,4,3,3,3,3,2,2,2,2,0;
0,20,20,20,20,20,19,19,19,19,19,19,18,18,18,18,17,17,17,17,16,16,16,16,16,16,15,15,15,15,15,15,15,14,14,14,14,14,14,14,14,13,13,13,13,13,13,13,13,12,12,12,12,12,12,12,12,11,11,11,11,11,11,10,10,10,10,10,9,9,9,9,9,8,8,8,8,7,7,7,7,6,6,6,5,5,5,4,4,4,4,3,3,3,2,2,2,2,2,0;
0,20,20,20,20,20,19,19,19,19,19,19,18,18,18,18,17,17,17,17,17,16,16,16,16,16,15,15,15,15,15,15,15,14,14,14,14,14,14,14,14,14,13,13,13,13,13,13,13,13,12,12,12,12,12,12,12,11,11,11,11,11,11,10,10,10,10,10,9,9,9,9,9,8,8,8,8,7,7,7,7,6,6,6,5,5,5,4,4,4,3,3,3,3,2,2,2,2,2,0;
0,20,20,20,20,20,19,19,19,19,19,19,18,18,18,18,17,17,17,17,17,16,16,16,16,16,15,15,15,15,15,15,15,14,14,14,14,14,14,14,14,14,13,13,13,13,13,13,13,13,13,12,12,12,12,12,12,12,11,11,11,11,11,11,10,10,10,10,9,9,9,9,9,8,8,8,8,7,7,7,6,6,6,6,5,5,5,4,4,4,3,3,3,3,2,2,2,2,2,0;
0,20,20,20,20,20,20,19,19,19,19,19,18,18,18,18,17,17,17,17,17,16,16,16,16,16,15,15,15,15,15,15,15,15,14,14,14,14,14,14,14,14,14,13,13,13,13,13,13,13,13,13,12,12,12,12,12,12,12,11,11,11,11,11,10,10,10,10,9,9,9,9,9,8,8,8,8,7,7,7,6,6,6,5,5,5,4,4,4,4,3,3,3,2,2,2,2,2,1,0;
0,20,20,20,20,20,20,19,19,19,19,19,18,18,18,18,18,17,17,17,17,16,16,16,16,16,15,15,15,15,15,15,15,15,14,14,14,14,14,14,14,14,14,14,13,13,13,13,13,13,13,13,13,12,12,12,12,12,12,11,11,11,11,11,10,10,10,10,9,9,9,9,8,8,8,8,7,7,7,7,6,6,6,5,5,5,4,4,4,3,3,3,3,2,2,2,2,2,1,0;
0,20,20,20,20,20,20,19,19,19,19,19,18,18,18,18,18,17,17,17,17,16,16,16,16,16,15,15,15,15,15,15,15,15,15,14,14,14,14,14,14,14,14,14,14,13,13,13,13,13,13,13,13,12,12,12,12,12,12,11,11,11,11,11,10,10,10,10,9,9,9,9,8,8,8,8,7,7,7,7,6,6,6,5,5,5,4,4,4,3,3,3,3,2,2,2,2,1,1,0;
0,20,20,20,20,20,20,19,19,19,19,19,18,18,18,18,18,17,17,17,17,16,16,16,16,16,16,15,15,15,15,15,15,15,15,14,14,14,14,14,14,14,14,14,14,14,13,13,13,13,13,13,13,13,12,12,12,12,12,12,11,11,11,11,10,10,10,10,9,9,9,9,8,8,8,8,7,7,7,7,6,6,6,5,5,5,4,4,4,3,3,3,2,2,2,2,2,1,1,0;
0,20,20,20,20,20,20,19,19,19,19,19,18,18,18,18,18,17,17,17,17,16,16,16,16,16,16,15,15,15,15,15,15,15,15,14,14,14,14,14,14,14,14,14,14,14,13,13,13,13,13,13,13,13,12,12,12,12,12,12,11,11,11,11,10,10,10,10,9,9,9,9,8,8,8,8,7,7,7,6,6,6,6,5,5,5,4,4,4,3,3,3,2,2,2,2,1,1,1,0;
0,0,0,0,0,0,0,0,0,0,0,0,0,0,0,0,0,0,0,0,0,0,0,0,0,0,0,0,0,0,0,0,0,0,0,0,0,0,0,0,0,0,0,0,0,0,0,0,0,0,0,0,0,0,0,0,0,0,0,0,0,0,0,0,0,0,0,0,0,0,0,0,0,0,0,0,0,0,0,0,0,0,0,0,0,0,0,0,0,0,0,0,0,0,0,0,0,0,0,0;
