0,0,0,0,0,0,0,0,0,0,0,0,0,0,0,0,0,0,0,0,0,0;
0,10,13,15,17,17,17,20,19,19,18,17,17,17,19,18,16,15,13,12,10,0;
0,9,12,15,17,18,19,21,20,20,20,17,17,18,20,19,16,14,14,13,12,0;
0,8,12,14,16,19,20,21,21,22,20,18,18,19,20,19,17,15,14,14,12,0;
0,7,10,14,16,18,19,20,22,22,21,20,20,22,21,20,18,17,16,15,13,0;
0,7,9,12,16,17,19,19,21,22,23,22,23,23,22,21,19,19,18,16,14,0;
0,7,9,12,16,17,19,20,21,22,23,23,24,22,22,21,20,20,19,17,15,0;
0,6,8,11,14,16,18,20,21,22,22,23,23,22,21,21,21,21,19,17,15,0;
0,7,8,11,14,16,18,20,21,22,21,21,21,21,20,20,22,21,19,17,15,0;
0,8,9,11,14,16,18,20,21,21,21,20,21,21,19,20,21,20,19,17,17,0;
0,10,10,10,12,14,16,19,20,21,21,21,21,20,19,19,20,20,19,18,19,0;
0,11,10,11,12,14,15,18,21,22,21,23,22,20,20,19,19,19,18,19,20,0;
0,11,11,11,12,14,16,18,21,22,22,22,21,20,20,19,18,18,18,19,19,0;
0,10,10,12,13,14,17,18,20,21,21,20,21,20,20,19,19,18,18,18,18,0;
0,10,10,11,12,14,16,18,18,19,20,21,20,19,19,19,20,19,19,18,16,0;
0,10,11,12,12,14,16,18,18,19,19,20,20,19,19,19,20,19,19,18,16,0;
0,11,11,12,13,15,16,18,19,20,20,20,20,20,19,19,19,18,18,17,15,0;
0,11,12,12,14,15,17,19,19,19,21,20,21,21,20,20,19,17,17,15,14,0;
0,14,15,15,16,16,17,18,18,19,20,19,19,20,20,20,19,17,16,14,13,0;
0,17,18,17,17,16,16,16,17,17,17,17,17,18,19,19,18,17,15,14,13,0;
0,0,0,0,0,0,0,0,0,0,0,0,0,0,0,0,0,0,0,0,0,0;
