0,0,0,0,0,0,0,0,0,0,0,0,0,0,0,0,0,0,0,0;
0,26,27,30,32,32,31,24,24,24,23,22,22,22,21,19,19,17,17,0;
0,24,27,29,32,31,31,31,26,24,24,23,22,23,23,22,22,21,21,0;
0,25,26,30,31,30,30,30,31,30,24,23,22,23,23,23,24,24,23,0;
0,27,24,26,31,30,29,29,29,28,29,22,22,22,22,23,24,25,24,0;
0,28,25,25,32,30,30,29,27,26,27,28,22,21,22,24,25,25,25,0;
0,29,25,22,30,31,29,28,26,25,25,26,27,20,22,24,25,25,24,0;
0,30,27,24,24,31,29,28,26,25,25,26,26,27,21,23,23,23,24,0;
0,31,28,25,23,24,29,28,26,25,25,26,27,26,27,21,21,21,22,0;
0,31,29,25,23,23,25,28,27,26,26,27,27,26,27,28,19,19,20,0;
0,31,29,26,23,21,23,24,27,27,26,27,27,27,27,27,19,18,18,0;
0,30,28,26,22,19,20,21,24,28,27,27,26,26,26,26,24,17,17,0;
0,29,27,25,22,19,18,19,21,24,28,27,26,26,26,25,23,23,16,0;
0,30,28,26,23,20,17,18,19,21,23,27,26,27,26,25,24,24,17,0;
0,30,29,27,24,22,19,18,19,19,20,21,23,26,26,25,25,24,24,0;
0,29,29,29,26,23,21,19,18,19,17,19,21,23,25,25,25,25,25,0;
0,23,30,28,26,24,21,20,18,18,18,17,19,22,21,22,22,26,27,0;
0,23,23,29,26,23,21,20,19,18,17,18,18,20,19,20,21,24,25,0;
0,23,23,23,26,23,21,20,20,18,16,17,19,18,19,19,22,23,24,0;
0,0,0,0,0,0,0,0,0,0,0,0,0,0,0,0,0,0,0,0;
