0,0,0,0,0,0,0,0,0,0,0,0,0,0,0,0,0,0,0,0,0,0,0,0,0,0,0,0,0,0,0,0,0,0,0,0,0,0,0,0,0,0,0,0,0,0,0,0,0,0,0,0,0,0,0,0,0,0,0,0,0,0,0,0,0,0,0,0,0,0,0;
0,0,0,0,0,0,0,0,0,0,0,0,0,0,0,0,0,0,0,0,0,0,0,0,0,0,0,0,0,0,0,0,0,0,0,0,0,0,0,0,0,0,0,0,0,0,0,0,0,0,0,0,0,0,0,0,0,0,0,0,0,0,0,0,0,0,0,0,0,0,0;
0,0,0,0,0,0,0,0,0,0,0,0,0,0,0,0,0,0,0,0,0,0,0,0,0,0,0,0,0,0,0,0,0,0,0,0,0,3,0,0,0,0,0,0,0,0,0,0,0,0,0,0,0,0,0,0,0,0,0,0,0,0,0,0,0,0,0,0,0,0,0;
0,0,0,0,0,0,0,0,0,0,0,0,0,0,0,0,0,0,0,0,0,0,8,8,8,12,12,17,21,9,9,0,0,0,4,6,2,5,3,0,4,14,1,0,0,0,0,0,0,0,0,0,0,0,0,0,0,0,0,0,0,0,0,0,0,0,0,0,0,0,0;
0,0,0,0,0,0,0,0,0,0,0,0,0,9,11,20,19,7,3,0,22,50,50,36,24,22,17,26,17,21,9,0,0,0,4,4,6,5,3,3,5,17,23,18,11,2,0,0,0,0,0,0,0,0,0,0,0,0,0,0,0,0,0,0,0,0,0,0,0,0,0;
0,0,0,0,0,0,0,0,0,0,6,4,0,9,16,26,22,19,7,3,16,44,58,50,34,25,18,23,21,25,11,22,23,16,10,21,36,36,26,3,0,11,22,27,20,15,11,9,0,0,0,0,0,0,0,0,0,0,0,0,0,0,0,0,0,0,0,0,0,0,0;
0,0,0,0,0,0,0,0,0,28,32,16,6,2,14,20,26,20,17,3,3,22,44,51,36,20,16,14,7,10,2,10,21,26,17,16,25,38,30,18,0,0,11,22,21,17,16,16,16,19,11,0,0,0,0,0,0,0,0,0,0,0,0,0,0,0,0,0,0,0,0;
0,0,0,0,0,0,0,0,10,26,34,40,16,2,0,13,10,4,0,0,0,0,0,0,0,9,15,9,5,0,2,2,15,22,21,11,17,22,35,25,8,0,0,0,0,9,9,13,16,23,19,17,0,0,0,0,0,0,0,0,0,0,0,0,0,0,0,0,0,0,0;
0,0,0,0,0,0,0,7,20,10,34,34,34,4,0,0,0,0,0,0,0,0,0,0,14,15,17,16,9,0,0,0,2,0,0,0,0,0,0,4,7,0,0,0,0,0,0,0,4,12,21,20,16,0,0,0,0,0,0,0,0,0,0,0,0,0,0,0,0,0,0;
0,0,0,0,0,0,0,10,16,22,13,20,22,0,0,0,0,0,0,0,0,0,0,0,30,38,23,17,12,5,0,0,0,0,0,0,0,0,0,0,0,0,0,0,0,0,0,0,0,0,0,16,22,17,12,0,0,0,0,0,0,0,0,0,0,0,0,0,0,0,0;
0,0,0,0,0,0,0,4,16,16,22,10,0,0,0,0,0,0,0,0,0,0,0,0,22,32,38,15,0,0,0,0,0,0,0,0,0,0,0,0,0,0,0,0,0,0,0,0,0,0,0,0,4,16,12,6,0,0,0,0,0,0,0,0,0,0,0,0,0,0,0;
0,0,0,0,0,0,0,0,4,11,14,0,0,0,0,0,0,0,0,0,0,0,0,0,0,22,30,10,0,0,0,0,0,0,0,0,0,0,0,0,0,0,0,0,0,0,0,0,0,0,0,0,0,0,16,32,12,0,0,0,0,0,0,0,0,0,0,0,0,0,0;
0,0,0,0,0,0,0,0,0,0,0,0,0,0,0,0,0,0,0,0,6,10,8,4,0,0,2,0,0,0,0,0,0,0,0,0,0,0,0,0,0,3,4,0,0,0,0,0,0,0,0,0,0,0,0,26,30,21,0,0,0,0,0,0,0,0,0,0,0,0,0;
0,0,0,0,0,0,0,0,0,0,0,0,0,0,0,0,0,0,6,10,14,18,11,8,4,0,0,0,0,0,0,0,0,0,0,0,0,0,0,0,0,11,10,6,2,0,0,0,0,0,0,0,0,0,0,11,30,30,0,0,0,0,0,0,0,0,0,0,0,0,0;
0,0,0,0,0,0,0,0,0,0,0,0,0,0,0,0,13,16,16,6,17,14,17,9,4,0,0,0,0,0,0,0,0,0,0,0,0,0,0,0,0,19,17,13,7,5,0,0,0,0,0,0,0,0,0,0,13,29,10,0,0,0,0,0,0,0,0,0,0,0,0;
0,0,0,0,0,0,0,0,0,0,0,0,0,0,0,4,15,25,22,16,6,11,14,1,0,0,0,0,0,0,0,0,0,0,0,0,0,0,0,0,0,22,24,19,8,11,14,0,0,0,0,0,0,0,0,0,3,8,10,0,0,0,0,0,0,0,0,0,0,0,0;
0,0,0,0,0,0,0,0,0,0,0,0,0,3,3,3,10,15,25,14,6,0,0,0,0,0,0,0,0,0,0,0,0,0,0,0,0,0,0,0,10,18,26,23,1,10,20,24,7,0,0,0,0,0,0,0,0,3,3,3,0,0,0,0,0,0,0,0,0,0,0;
0,0,18,12,0,0,0,0,0,0,0,0,0,8,6,9,3,6,15,6,0,0,0,0,0,0,0,0,0,0,0,0,0,0,0,2,2,0,4,11,9,13,20,22,0,0,11,29,26,12,0,0,0,0,0,0,0,0,0,0,0,0,0,0,0,0,0,0,0,0,0;
0,0,18,18,12,0,0,0,0,0,0,0,15,14,16,6,3,3,0,0,0,0,0,0,0,0,0,0,0,0,0,0,0,0,0,2,2,11,20,22,11,11,11,9,0,0,0,13,23,28,10,0,0,0,0,0,0,0,2,0,0,0,0,0,0,0,0,0,0,0,0;
0,0,6,18,18,2,0,0,0,0,0,0,14,23,18,16,6,0,0,0,0,0,0,0,0,0,0,0,0,0,0,0,0,0,0,0,10,24,28,26,22,11,4,0,0,0,0,0,0,24,18,12,0,0,0,0,0,6,10,10,0,0,0,0,0,0,0,0,0,0,0;
0,6,6,2,14,0,0,0,0,0,0,0,10,22,26,17,0,0,0,0,0,0,0,0,0,0,0,0,0,0,0,7,8,2,2,14,17,17,25,26,22,17,0,0,0,0,0,0,0,0,18,21,10,0,0,0,0,0,10,10,10,0,0,0,0,0,0,0,0,0,0;
0,16,6,6,0,0,0,0,0,0,0,0,0,21,26,15,0,0,0,0,0,0,0,0,0,0,0,0,0,0,5,18,17,20,24,18,17,21,15,22,11,0,0,0,0,0,0,0,0,0,0,23,17,13,0,0,0,0,4,14,10,0,0,0,0,0,0,0,0,0,0;
0,18,16,6,0,0,0,0,0,0,0,0,0,13,24,18,0,0,0,0,0,0,0,0,0,0,0,0,0,0,5,18,36,39,44,32,28,16,11,6,0,0,0,0,0,0,0,0,0,0,0,0,15,15,2,0,0,0,8,8,8,0,0,0,0,0,0,0,0,0,0;
0,27,18,8,0,0,0,0,0,0,0,0,0,0,24,25,0,0,0,0,0,0,0,0,0,0,0,0,0,0,8,46,52,61,53,43,32,13,7,0,0,0,0,0,0,0,0,0,0,0,0,0,2,11,10,0,0,0,0,8,8,8,0,0,0,0,0,0,0,0,0;
0,24,25,0,0,0,0,0,0,0,0,0,0,0,16,21,19,0,0,0,0,0,0,0,0,0,0,0,0,0,4,21,43,51,45,62,39,11,0,0,0,0,0,0,0,0,0,0,0,0,0,0,0,7,11,7,0,0,0,0,8,8,0,0,0,0,0,0,0,0,0;
0,21,12,0,0,0,0,0,0,0,0,0,0,0,0,29,31,4,0,0,0,0,0,0,0,0,0,4,0,0,0,6,24,34,47,59,46,12,0,0,0,0,0,0,0,0,0,0,0,0,0,0,0,0,20,15,2,0,0,0,0,0,0,0,0,0,0,0,0,0,0;
0,12,0,0,0,0,0,0,0,0,0,0,0,0,0,4,25,23,0,0,0,0,0,0,0,6,6,4,4,0,0,0,2,4,9,45,50,25,7,0,0,3,0,0,0,0,0,0,0,0,0,0,0,0,23,25,22,0,0,0,0,0,0,0,0,0,0,0,0,0,0;
0,0,0,0,0,0,0,0,0,0,0,0,0,0,0,0,21,28,23,0,0,0,0,4,0,6,6,10,4,4,0,0,0,0,11,30,55,34,11,15,15,16,21,16,10,0,0,0,0,0,0,0,0,0,4,25,21,11,0,0,0,0,0,0,0,0,0,0,0,0,0;
0,0,0,0,0,0,0,0,0,0,0,0,0,0,0,0,0,16,20,14,0,15,16,4,4,0,6,6,6,4,0,0,0,0,5,21,39,52,23,23,17,18,20,26,22,26,0,0,0,0,0,0,0,0,16,18,19,15,0,0,4,0,0,0,0,0,0,0,0,0,0;
0,17,0,0,0,0,0,0,0,0,0,0,0,0,0,0,0,0,18,24,28,23,19,19,4,4,0,6,0,0,0,0,0,0,3,6,23,32,25,24,19,17,13,21,19,28,23,0,0,0,0,0,0,0,12,16,16,4,0,0,4,4,4,0,0,0,0,0,0,0,0;
0,11,6,0,0,0,0,0,0,0,0,0,0,0,0,0,0,0,0,19,25,26,28,18,16,4,0,0,0,0,0,0,0,0,1,3,5,2,10,12,10,17,0,0,0,25,23,23,0,0,0,0,0,0,0,12,16,13,0,0,0,9,4,0,0,0,0,0,0,0,0;
0,4,4,0,0,0,0,0,0,0,0,0,0,0,0,0,0,0,0,0,14,22,19,13,15,0,0,0,0,0,0,0,0,0,0,0,2,0,0,0,0,0,0,0,0,0,10,20,11,8,0,0,0,0,0,0,3,0,0,0,0,18,20,2,0,0,0,0,0,0,0;
0,0,0,0,0,0,0,0,0,0,0,0,0,0,0,0,0,0,0,0,0,0,8,0,0,0,0,0,0,0,0,0,0,0,0,0,0,0,0,0,0,0,0,0,0,0,0,8,21,17,0,0,0,8,8,0,0,0,0,0,0,28,28,20,0,0,0,0,0,0,0;
0,0,0,0,0,0,0,0,0,0,0,0,0,0,0,0,0,0,0,0,0,0,0,0,0,0,0,0,0,0,0,0,0,0,0,0,0,0,0,0,0,0,0,0,0,0,0,0,20,28,11,0,0,8,8,8,0,0,0,0,0,18,38,34,0,0,0,0,0,0,0;
0,0,0,0,0,0,0,0,0,0,0,0,0,0,0,0,0,0,0,0,0,0,0,0,0,0,0,0,0,0,0,0,0,0,0,0,0,0,0,0,0,0,0,0,0,0,0,0,10,20,20,0,0,0,8,8,0,0,0,0,0,0,23,30,16,0,0,0,0,0,0;
0,0,0,0,0,0,0,0,0,0,0,0,0,0,0,0,0,0,0,0,0,0,0,0,0,0,0,0,0,0,0,0,0,0,0,0,0,0,0,0,0,0,0,0,0,0,0,0,0,9,15,0,0,0,0,0,0,0,0,0,0,0,11,18,18,0,0,0,0,0,0;
0,0,0,0,0,0,6,6,0,0,0,0,0,0,0,0,0,0,0,0,0,0,0,0,0,0,0,0,0,0,0,0,0,0,0,0,0,0,0,0,0,0,0,0,0,0,0,0,0,0,0,0,0,0,0,0,0,0,0,0,0,0,4,14,13,0,0,0,0,0,0;
0,0,0,0,0,0,6,10,9,0,0,0,0,0,0,0,0,0,0,0,0,0,0,0,0,0,0,0,0,0,0,0,0,0,0,0,0,0,0,0,0,0,0,0,0,0,0,0,0,0,0,0,0,0,0,0,0,0,0,0,0,0,0,7,9,4,0,0,0,0,0;
0,0,0,0,0,0,0,12,15,14,0,0,0,0,0,0,0,5,5,4,0,0,0,0,0,0,0,0,0,0,0,0,0,0,0,0,0,0,0,0,0,0,0,0,0,0,0,0,0,0,0,0,0,0,0,0,0,0,0,0,0,0,0,5,7,6,0,0,0,0,0;
0,0,0,0,0,0,0,0,21,26,16,0,0,0,0,0,0,3,6,5,4,0,0,0,0,0,0,0,0,0,0,0,0,0,0,0,0,0,0,0,0,0,0,0,0,0,0,0,0,0,0,0,0,0,14,8,0,0,0,0,0,0,0,9,13,5,0,0,0,0,0;
0,0,0,0,0,0,0,0,0,17,23,17,0,0,0,0,0,3,3,6,4,0,0,0,0,0,0,0,0,0,0,0,0,0,0,0,0,0,0,0,0,0,0,0,0,0,0,0,0,0,6,6,0,0,34,32,18,0,0,0,0,0,0,10,18,13,1,0,0,0,0;
0,0,0,0,0,0,0,0,0,0,20,25,20,0,0,0,0,3,4,4,0,0,20,22,0,0,0,0,0,0,0,0,0,0,0,0,0,0,0,0,0,4,6,8,12,6,8,8,10,14,14,6,6,0,26,42,36,14,0,0,0,0,0,2,27,19,11,0,0,0,0;
0,0,0,0,0,0,0,0,0,0,0,13,20,14,6,0,0,2,4,3,0,0,20,24,31,11,0,0,0,0,0,0,0,0,0,0,0,0,6,14,20,20,18,18,18,16,14,12,14,20,14,14,6,6,16,38,42,30,0,0,0,0,0,0,18,25,15,0,0,0,0;
0,0,0,0,0,0,0,0,0,0,0,0,20,14,12,6,3,2,3,3,0,0,0,22,32,28,20,1,0,0,0,0,0,0,0,4,16,26,26,26,28,24,22,20,18,16,14,12,14,14,20,10,4,12,22,26,28,14,0,0,0,0,0,0,10,16,18,0,0,0,0;
0,0,0,0,0,0,0,0,0,0,0,0,0,3,7,6,6,9,4,2,0,0,0,0,4,14,23,26,20,4,0,0,8,24,34,34,32,32,32,30,30,24,18,14,14,12,6,8,6,4,10,6,2,13,12,22,22,0,0,0,0,0,0,0,4,14,10,0,0,0,0;
0,0,0,0,0,0,0,0,0,0,0,0,0,0,0,0,6,12,5,3,0,0,0,0,0,0,16,26,28,18,14,4,53,75,72,52,46,34,28,26,22,16,2,0,0,0,0,0,0,0,0,0,0,9,13,12,12,0,0,0,0,0,0,0,4,4,4,0,0,0,0;
0,0,0,0,0,0,0,0,0,0,0,0,0,0,0,0,0,9,6,5,0,0,0,0,0,0,0,0,18,18,14,4,39,61,85,58,42,26,14,4,0,0,0,0,0,0,0,0,0,0,0,0,0,9,9,9,0,0,0,0,0,0,0,0,0,4,4,0,0,0,0;
0,0,0,0,0,0,0,0,0,0,0,0,0,0,0,0,3,7,6,6,0,0,0,0,0,0,0,0,0,0,10,4,4,35,61,46,34,2,0,0,0,0,0,0,0,0,0,0,0,3,3,0,0,0,0,9,0,0,0,0,0,0,0,0,0,0,0,0,0,0,0;
0,0,0,0,0,0,0,0,0,0,0,0,0,0,0,0,5,9,8,4,0,0,0,2,10,12,0,0,0,0,0,0,0,0,0,0,0,0,0,0,0,0,0,0,0,0,0,0,0,3,3,3,0,0,0,0,0,0,0,0,0,0,0,0,0,0,0,0,0,0,0;
0,0,0,0,0,0,0,0,0,0,0,0,0,0,0,0,7,10,8,5,0,0,0,0,12,19,32,11,4,0,0,0,0,0,0,0,0,0,0,3,0,0,3,3,0,0,0,0,0,0,3,3,0,0,0,0,0,0,0,0,0,0,0,0,0,0,0,0,0,0,0;
0,0,0,0,0,0,0,0,0,0,0,0,0,0,0,0,8,9,9,6,0,0,0,0,0,16,32,30,32,24,20,7,0,0,0,0,16,16,8,3,3,3,3,3,3,0,0,0,0,0,0,3,0,0,0,0,0,0,0,0,0,0,0,0,0,0,0,0,0,0,0;
0,0,0,0,0,0,0,0,0,0,0,0,0,0,0,0,8,10,10,4,0,0,0,0,0,0,16,24,28,25,31,17,7,0,0,0,8,16,16,11,3,3,0,3,3,0,0,0,0,0,0,0,0,0,0,0,0,0,0,0,0,0,0,0,0,0,0,0,0,0,0;
0,0,0,0,0,0,0,0,0,0,0,0,0,0,0,3,9,9,9,1,0,0,0,0,0,0,0,0,15,18,24,20,13,0,0,0,0,8,16,16,0,3,0,0,3,0,0,0,0,0,0,0,0,0,0,0,0,0,0,0,0,0,0,0,0,0,0,0,0,0,0;
0,0,0,0,0,0,0,0,0,0,0,0,0,0,0,4,11,10,8,0,0,0,0,0,0,0,0,0,0,0,0,0,1,0,0,0,0,0,0,0,0,0,0,0,0,0,0,0,0,0,0,0,0,0,0,0,0,0,0,0,0,0,0,0,0,0,0,0,0,0,0;
0,0,0,0,0,0,0,0,0,0,0,0,0,0,0,11,17,12,9,0,0,0,0,0,0,0,0,0,0,0,0,0,0,0,0,0,0,0,0,0,0,0,0,0,0,0,0,0,0,0,0,0,0,0,0,0,0,0,0,0,0,0,0,0,0,0,0,0,0,0,0;
0,0,0,0,0,0,0,0,0,0,0,0,0,0,0,18,22,19,9,0,0,0,0,0,0,0,0,0,0,0,0,0,0,0,0,0,0,0,0,0,0,0,0,0,0,0,0,0,0,0,0,0,0,0,0,0,0,4,0,0,0,0,0,0,0,0,0,0,0,0,0;
0,0,0,0,0,0,0,0,0,0,0,0,0,0,0,41,54,42,14,0,0,0,0,0,0,0,0,0,0,0,0,0,0,0,0,0,0,0,0,0,0,0,0,0,0,0,0,0,0,0,0,0,0,4,0,0,0,4,4,0,0,0,0,0,0,0,0,0,0,0,0;
0,0,0,0,0,0,0,0,0,0,0,0,0,0,0,15,44,51,26,0,0,0,0,0,0,0,0,0,0,0,0,0,0,0,0,0,0,0,0,0,0,11,11,0,0,0,0,0,0,4,0,0,0,4,4,4,0,4,4,4,0,0,0,0,0,0,0,0,0,0,0;
0,0,0,0,0,0,0,0,0,0,0,0,0,0,0,0,25,40,40,0,0,0,0,0,0,0,0,0,0,0,0,0,0,0,0,0,0,0,0,0,0,0,11,11,0,0,0,0,0,4,4,4,0,0,4,4,0,0,4,4,0,0,0,0,0,0,0,0,0,0,0;
0,0,0,0,0,0,0,0,0,0,0,0,0,0,0,0,0,8,22,14,0,0,0,0,0,0,0,0,0,0,0,0,0,0,0,0,0,0,0,0,0,0,11,11,11,0,0,0,0,0,4,4,4,0,0,4,4,0,0,0,0,0,0,0,0,0,0,0,0,0,0;
0,0,0,0,0,0,0,0,0,0,0,0,0,0,0,0,0,0,14,14,14,0,0,0,0,0,0,0,0,0,0,0,0,0,0,0,0,0,0,0,0,0,0,0,11,0,0,0,0,0,0,4,4,0,0,0,0,0,0,0,0,0,0,0,0,0,0,0,0,0,0;
0,0,0,0,0,0,0,0,0,0,0,0,0,0,0,0,0,0,0,14,17,3,0,0,0,0,0,0,0,0,0,0,8,8,0,0,0,0,0,0,0,0,0,0,0,0,0,0,0,0,0,0,0,0,0,0,0,0,0,0,0,0,0,0,0,0,0,0,0,0,0;
0,0,0,0,0,0,0,0,0,0,0,0,0,0,0,0,0,0,0,0,7,3,3,0,0,0,0,0,0,0,2,0,8,8,8,0,0,0,0,0,0,0,0,0,0,0,0,0,0,0,0,0,0,0,0,0,0,0,0,0,0,0,0,0,0,0,0,0,0,0,0;
0,0,0,0,0,0,0,0,0,0,0,0,0,0,0,0,0,0,0,0,0,3,3,3,0,0,0,0,3,3,5,2,0,8,8,0,0,0,0,0,0,0,0,0,0,0,0,0,0,0,0,0,0,0,0,0,0,0,0,0,0,0,0,0,0,0,0,0,0,0,0;
0,0,0,0,0,0,0,0,0,0,0,0,0,0,0,0,0,0,0,0,0,0,0,0,0,0,0,0,3,3,5,2,2,0,4,0,0,0,0,0,0,0,0,0,0,0,0,0,0,0,0,0,0,0,0,0,0,0,0,0,0,0,0,0,0,0,0,0,0,0,0;
0,0,0,0,0,0,0,0,0,0,0,0,0,0,0,0,0,0,0,0,0,0,0,0,0,0,0,0,0,3,3,5,2,0,0,0,0,0,0,0,0,0,0,0,0,0,0,0,0,0,0,0,0,0,0,0,0,0,0,0,0,0,0,0,0,0,0,0,0,0,0;
0,0,0,0,0,0,0,0,0,0,0,0,0,0,0,0,0,0,0,0,0,0,0,0,0,0,0,0,0,0,0,0,0,0,0,0,0,0,0,0,0,0,0,0,0,0,0,0,0,0,0,0,0,0,0,0,0,0,0,0,0,0,0,0,0,0,0,0,0,0,0;
0,0,0,0,0,0,0,0,0,0,0,0,0,0,0,0,0,0,0,0,0,0,0,0,0,0,0,0,0,0,0,0,0,0,0,0,0,0,0,0,0,0,0,0,0,0,0,0,0,0,0,0,0,0,0,0,0,0,0,0,0,0,0,0,0,0,0,0,0,0,0;
0,0,0,0,0,0,0,0,0,0,0,0,0,0,0,0,0,0,0,0,0,0,0,0,0,0,0,0,0,0,0,0,0,0,0,0,0,0,0,0,0,0,0,0,0,0,0,0,0,0,0,0,0,0,0,0,0,0,0,0,0,0,0,0,0,0,0,0,0,0,0;
0,0,0,0,0,0,0,0,0,0,0,0,0,0,0,0,0,0,0,0,0,0,0,0,0,0,0,0,0,0,0,0,0,0,0,0,0,0,0,0,0,0,0,0,0,0,0,0,0,0,0,0,0,0,0,0,0,0,0,0,0,0,0,0,0,0,0,0,0,0,0;
0,0,0,0,0,0,0,0,0,0,0,0,0,0,0,0,0,0,0,0,0,0,0,0,0,0,0,0,0,0,0,0,0,0,0,0,0,0,0,0,0,0,0,0,0,0,0,0,0,0,0,0,0,0,0,0,0,0,0,0,0,0,0,0,0,0,0,0,0,0,0;
0,0,0,0,0,0,0,0,0,0,0,0,0,0,0,0,0,0,0,0,0,0,0,0,0,0,0,0,0,0,0,0,0,0,0,0,0,0,0,0,0,0,0,0,0,0,0,0,0,0,0,0,0,0,0,0,0,0,0,0,0,0,0,0,0,0,0,0,0,0,0;
0,0,0,0,0,0,0,0,0,0,0,0,0,0,0,0,0,0,0,0,0,0,0,0,0,0,0,0,0,0,0,0,0,0,0,0,0,0,0,0,0,0,0,0,0,0,0,0,0,0,0,0,0,0,0,0,0,0,0,0,0,0,0,0,0,0,0,0,0,0,0;
